Bulgarian	English	Bulgarian_Example	English_Example
като	as	Той е висок като баща си.	He is tall like his father.
I	I	Аз съм студент.	I am a student.
си	his	Това е неговата си книга.	This is his book.
че	that	Знам, че ще дойде.	I know that he will come.
той	he	Той живее тук.	He lives here.
е	was	Той е учител.	He was a teacher.
за	for	Това е за теб.	This is for you.
на	on	Книгата е на масата.	The book is on the table.
са	are	Те са приятели.	They are friends.
с	with	Идвам с теб.	I'm coming with you.
те	they	Те играят футбол.	They play football.
бъде	be	Трябва да бъде готов.	It needs to be ready.
в	at	Съм в училище.	I'm at school.
един	one	Имам един брат.	I have one brother.
имат	have	Те имат кола.	They have a car.
тази	this	Тази книга е интересна.	This book is interesting.
от	from	Идвам от България.	I come from Bulgaria.
от	by	Книгата е написана от автора.	The book is written by the author.
горещ	hot	Днес е много горещо.	Today is very hot.
дума	word	Не разбирам тази дума.	I don't understand this word.
но	but	Искам да дойда, но съм зает.	I want to come, but I'm busy.
какво	what	Какво правиш?	What are you doing?
някои	some	Някои хора обичат кафе.	Some people like coffee.
е	is	Това е моята къща.	This is my house.
тя	it	Тя е красива.	She is beautiful.
ви	you	Как сте вие?	How are you?
или	or	Чай или кафе?	Tea or coffee?
имаше	had	Той имаше много приятели.	He had many friends.
на	the	На масата има книга.	There is a book on the table.
от	of	Част от торта.	A piece of cake.
да	to	Трябва да работя.	I have to work.
и	and	Хляб и масло.	Bread and butter.
а	a	Това е добра идея.	This is a good idea.
в	in	Живея в София.	I live in Sofia.
ние	we	Ние сме семейство.	We are a family.
може	can	Може да дойда утре.	I can come tomorrow.
от	out	Излязох от къщата.	I went out of the house.
други	other	Други хора мислят различно.	Other people think differently.
бяха	were	Те бяха много щастливи.	They were very happy.
които	which	Книгите, които чета.	The books which I read.
правя	do	Какво правя днес?	What do I do today?
си	their	Това е тяхната си къща.	This is their house.
време	time	Нямам време сега.	I don't have time now.
ако	if	Ако дойдеш, ще се радвам.	If you come, I'll be happy.
ще	will	Ще дойда утре.	I will come tomorrow.
как	how	Как се казваш?	What is your name?
каза	said	Той каза истината.	He said the truth.
един	an	Това е интересна книга.	This is an interesting book.
всеки	each	Всеки ден ходя на работа.	I go to work each day.
кажете	tell	Кажете ми какво мислите.	Tell me what you think.
прави	does	Какво прави той?	What does he do?
комплект	set	Купих комплект чинии.	I bought a set of plates.
три	three	Имам три деца.	I have three children.
искам	want	Искам да пътувам.	I want to travel.
въздух	air	Въздухът е свеж.	The air is fresh.
добре	well	Говоря добре английски.	I speak English well.
също	also	Също така обичам музика.	I also like music.
играе	play	Детето играе в парка.	The child plays in the park.
малък	small	Това е малка котка.	This is a small cat.
край	end	В края на филма.	At the end of the movie.
постави	put	Постави книгата на масата.	Put the book on the table.
Начало	home	Прибирам се у дома.	I'm going home.
Прочети	read	Чета интересна книга.	I read an interesting book.
ръка	hand	Дай ми ръката си.	Give me your hand.
порт	port	Корабът пристигна в порта.	The ship arrived at the port.
голям	large	Това е голяма къща.	This is a large house.
правописа	spell	Как се пише тази дума?	How do you spell this word?
добави	add	Добави мляко в кафето.	Add milk to the coffee.
още	even	Още не съм готов.	I'm not even ready.
земя	land	Купи земя в село.	He bought land in the village.
тук	here	Тук е много красиво.	It's very beautiful here.
трябва	must	Трябва да отида сега.	I must go now.
голям	big	Голям проблем.	A big problem.
високо	high	Планината е висока.	The mountain is high.
като	such	Такъв човек като теб.	Such a person like you.
следвайте	follow	Следвайте указанията.	Follow the instructions.
акт	act	Това е добър акт.	This is a good act.
защо	why	Защо не дойде?	Why didn't he come?
попитайте	ask	Попитайте го какво иска.	Ask him what he wants.
мъже	men	Мъжете работят в градината.	The men work in the garden.
промяна	change	Има промяна в плановете.	There's a change in the plans.
Отидох	went	Отидох в магазина.	I went to the store.
светлина	light	Включи светлината.	Turn on the light.
вид	kind	Какъв вид музика обичаш?	What kind of music do you like?
разстояние	off	Изключи лампата.	Turn off the lamp.
трябва	need	Трябва ми помощ.	I need help.
къща	house	Живея в малка къща.	I live in a small house.
снимка	picture	Направи снимка на гледката.	Take a picture of the view.
опитайте	try	Опитай тази храна.	Try this food.
нас	us	Той дойде при нас.	He came to us.
отново	again	Ще се видим отново.	We'll see each other again.
животните	animal	Обичам животните.	I love animals.
точка	point	Това е важна точка.	This is an important point.
майка	mother	Майка ми готви вечеря.	My mother cooks dinner.
свят	world	Светът е голям.	The world is big.
в близост	near	Живея близо до училище.	I live near the school.
изграждане	build	Строя нова къща.	I'm building a new house.
самостоятелно	self	Правя всичко сам.	I do everything by myself.
Земята	earth	Земята е кръгла.	The Earth is round.
баща	father	Баща ми е учител.	My father is a teacher.
всеки	any	Можеш да избереш който и да е.	You can choose any one.
нова	new	Купих нова кола.	I bought a new car.
работа	work	Работата ми е интересна.	My work is interesting.
част	part	Това е част от плана.	This is part of the plan.
предприеме	take	Взе книгата от масата.	He took the book from the table.
получите	get	Получих писмо днес.	I got a letter today.
място	place	Това е красиво място.	This is a beautiful place.
направи	made	Направи торта за рождения ден.	She made a cake for the birthday.
живея	live	Живея в София.	I live in Sofia.
където	where	Къде живееш?	Where do you live?
след	after	След работа ходя у дома.	After work I go home.
обратно	back	Върна се обратно у дома.	He went back home.
малко	little	Имам малко време.	I have little time.
само	only	Само аз знам истината.	Only I know the truth.
кръг	round	Масата е кръгла.	The table is round.
мъж	man	Този мъж е висок.	This man is tall.
година	year	Тази година е специална.	This year is special.
дойде	came	Той дойде вчера.	He came yesterday.
Покажи	show	Покажи ми снимката.	Show me the picture.
всеки	every	Всеки ден чета.	I read every day.
добър	good	Това е добра идея.	This is a good idea.
мен	me	Той ми каза истината.	He told me the truth.
даде	give	Дай ми водата.	Give me the water.
ни	our	Това е нашата къща.	This is our house.
под	under	Котката е под масата.	The cat is under the table.
име	name	Как се казваш?	What's your name?
много	very	Много съм щастлив.	I'm very happy.
чрез	through	Минах през парка.	I went through the park.
просто	just	Просто искам да помогна.	I just want to help.
форма	form	Попълни формата.	Fill out the form.
изречение	sentence	Това е дълго изречение.	This is a long sentence.
голям	great	Това е страхотна идея.	This is a great idea.
мисля	think	Мисля, че имаш право.	I think you're right.
каже	say	Какво ще кажеш?	What will you say?
помогне	help	Можеш ли да помогнеш?	Can you help?
ниска	low	Цената е ниска.	The price is low.
Онлайн	line	Застани на опашката.	Stand in line.
различава	differ	Мненията се различават.	Opinions differ.
ред	turn	Сега е моя ред.	Now it's my turn.
кауза	cause	Каква е причината?	What's the cause?
много	much	Много работа.	Much work.
означава	mean	Какво означава това?	What does this mean?
преди	before	Преди да заминеш.	Before you leave.
ход	move	Направи следващия ход.	Make the next move.
полето	right	Това е правилно.	This is right.
момче	boy	Момчето играе футбол.	The boy plays football.
стар	old	Това е стара къща.	This is an old house.
твърде	too	Твърде е горещо.	It's too hot.
същата	same	Същата история отново.	The same story again.
тя	she	Тя е моя сестра.	She is my sister.
всички	all	Всички са тук.	Everyone is here.
там	there	Той е там.	He is there.
когато	when	Кога ще дойдеш?	When will you come?
нагоре	up	Качи се нагоре.	Go up.
употреба	use	Използвай молива.	Use the pencil.
си	your	Това е твоята книга.	This is your book.
начин	way	По този начин.	This way.
за	about	Говорим за работа.	We're talking about work.
много	many	Много хора дойдоха.	Many people came.
след това	then	След това отидохме у дома.	Then we went home.
тях	them	Видях ги вчера.	I saw them yesterday.
напиши	write	Напиши писмо.	Write a letter.
би	would	Бих искал да дойда.	I would like to come.
като	like	Обичам музика като тази.	I like music like this.
така	so	Така е по-добре.	So it's better.
тези	these	Тези книги са интересни.	These books are interesting.
си	her	Това е нейната чанта.	This is her bag.
дълго	long	Дълга разходка.	A long walk.
направи	make	Направи кафе.	Make coffee.
нещо	thing	Това е странно нещо.	This is a strange thing.
виждам	see	Виждам те утре.	I'll see you tomorrow.
го	him	Видях го в парка.	I saw him in the park.
две	two	Имам две кучета.	I have two dogs.
има	has	Той има нова кола.	He has a new car.
потърсите	look	Погледни навън.	Look outside.
още	more	Искам още кафе.	I want more coffee.
дни	day	Хубав ден днес.	Nice day today.
може	could	Можех да дойда.	I could come.
отидете	go	Иди в магазина.	Go to the store.
дойде	come	Ела при мен.	Come to me.
направих	did	Направих домашното.	I did the homework.
брой	number	Каква е твоя номер?	What's your number?
звучи	sound	Това звучи добре.	That sounds good.
не	no	Не, благодаря.	No, thank you.
най-	most	Най-хубавата песен.	The most beautiful song.
хора	people	Много хора са тук.	Many people are here.
ми	my	Това е моето име.	This is my name.
над	over	Самолетът лети над града.	The plane flies over the city.
знаете	know	Знаеш ли отговора?	Do you know the answer?
вода	water	Пия вода всеки ден.	I drink water every day.
от	than	По-висок от мен.	Taller than me.
повикване	call	Обади ми се утре.	Call me tomorrow.
първи	first	Това е първия път.	This is the first time.
които	who	Хората, които работят тук.	The people who work here.
може	may	Може да дойда късно.	I may come late.
надолу	down	Слез надолу.	Go down.
страна	side	От тази страна.	From this side.
бил	been	Бил съм в Париж.	I've been to Paris.
сега	now	Сега съм готов.	I'm ready now.
намерите	find	Намери ключа.	Find the key.
главата	head	Боли ме главата.	My head hurts.
стоя	stand	Стой тук.	Stand here.
собствена	own	Това е моя собствена кола.	This is my own car.
страница	page	Прочети тази страница.	Read this page.
трябва	should	Трябва да отидеш.	You should go.
страна	country	България е красива страна.	Bulgaria is a beautiful country.
Намерени	found	Намерих ключа.	I found the key.
отговор	answer	Знаеш ли отговора?	Do you know the answer?
училище	school	Децата отиват на училище.	Children go to school.
растат	grow	Растенията растат бързо.	Plants grow fast.
проучване	study	Уча за изпита.	I study for the exam.
още	still	Още съм тук.	I'm still here.
научат	learn	Уча нови думи.	I learn new words.
растителна	plant	Засади растение в градината.	Plant a flower in the garden.
капак	cover	Покрий храната.	Cover the food.
храна	food	Обичам българската храна.	I love Bulgarian food.
слънце	sun	Слънцето грее ярко.	The sun shines brightly.
четири	four	Имам четири котки.	I have four cats.
между	between	Между нас казано.	Between you and me.
състояние	state	В добро състояние.	In good condition.
запази	keep	Запази тайната.	Keep the secret.
око	eye	Имаш красиви очи.	You have beautiful eyes.
Никога не	never	Никога не казвай никога.	Never say never.
последно	last	Това е последният път.	This is the last time.
нека	let	Нека да отидем.	Let's go.
Мислех	thought	Мислех за теб.	I thought about you.
град	city	София е голям град.	Sofia is a big city.
дърво	tree	Дървото е високо.	The tree is tall.
пресекат	cross	Пресечи улицата.	Cross the street.
ферма	farm	Работи във фермата.	He works on the farm.
Трудно	hard	Това е трудна задача.	This is a hard task.
начало	start	В началото на филма.	At the start of the movie.
мощ	might	Може би ще дойде.	He might come.
история	story	Разкажи ми история.	Tell me a story.
трион	saw	Видях те вчера.	I saw you yesterday.
Доколкото	far	Доколкото знам.	As far as I know.
море	sea	Морето е синьо.	The sea is blue.
изготвя	draw	Нарисувай картина.	Draw a picture.
наляво	left	Завий наляво.	Turn left.
късно	late	Закъснях за срещата.	I'm late for the meeting.
Run	run	Тичам всяка сутрин.	I run every morning.
не	don't	Не правя това.	I don't do that.
докато	while	Докато работя.	While I work.
натиснете	press	Натисни копчето.	Press the button.
в близост	close	Затвори вратата.	Close the door.
нощ	night	Лека нощ!	Good night!
недвижими	real	Това е истинска история.	This is a real story.
живот	life	Животът е красив.	Life is beautiful.
малцина	few	Малко хора знаят това.	Few people know this.
на север	north	На север от града.	North of the city.
книга	book	Чета интересна книга.	I'm reading an interesting book.
извършване	carry	Нося тежка чанта.	I carry a heavy bag.
взе	took	Взе ключа от масата.	He took the key from the table.
науката	science	Науката е важна.	Science is important.
яде	eat	Ям здравословна храна.	I eat healthy food.
стая	room	Стаята е голяма.	The room is big.
приятел	friend	Той е мой приятел.	He is my friend.
започна	began	Дъждът започна да вали.	The rain began to fall.
идея	idea	Това е добра идея.	This is a good idea.
риба	fish	Рибата плува в реката.	The fish swims in the river.
планина	mountain	Планината е висока.	The mountain is high.
спрете	stop	Спри колата.	Stop the car.
веднъж	once	Веднъж имах куче.	I once had a dog.
база	base	Базата е тук.	The base is here.
Слушайте	hear	Чувам музика.	I hear music.
кон	horse	Конят галопира.	The horse gallops.
нарязани	cut	Нарежи хляба.	Cut the bread.
сигурен	sure	Сигурен ли си?	Are you sure?
гледате	watch	Гледам телевизия.	I watch television.
цвят	color	Какъв е любимия ти цвят?	What's your favorite color?
Лицето	face	Умий си лицето.	Wash your face.
дърво	wood	Масата е от дърво.	The table is made of wood.
Основната	main	Главната улица.	The main street.
отворен	open	Отвори прозореца.	Open the window.
изглежда	seem	Изглежда доволен.	He seems happy.
заедно	together	Работим заедно.	We work together.
Следващата	next	Следващата седмица.	Next week.
бяло	white	Бялата риза.	The white shirt.
деца	children	Децата играят.	The children play.
започне	begin	Започни да работиш.	Begin to work.
имам	got	Получих подарък.	I got a gift.
ходи	walk	Разхождам се в парка.	I walk in the park.
Например	example	Например, като теб.	For example, like you.
облекчи	ease	Олекоти болката.	Ease the pain.
хартия	paper	Напиши на хартия.	Write on paper.
група	group	Група приятели.	A group of friends.
винаги	always	Винаги съм тук.	I'm always here.
музика	music	Обичам класическа музика.	I love classical music.
тези	those	Тези хора са мили.	Those people are nice.
и двете	both	И двете опции са добри.	Both options are good.
марка	mark	Остави марка на страницата.	Mark the page.
често	often	Често ходя на кино.	I often go to the cinema.
писмо	letter	Получих писмо.	I received a letter.
докато	until	Чакай докато дойда.	Wait until I come.
мили	mile	Километър е различен от миля.	A kilometer is different from a mile.
река	river	Реката тече бързо.	The river flows fast.
кола	car	Колата е нова.	The car is new.
фута	feet	Стой на краката си.	Stand on your feet.
грижи	care	Грижа се за теб.	I care for you.
втора	second	Това е втория път.	This is the second time.
достатъчно	enough	Имам достатъчно пари.	I have enough money.
обикновен	plain	Обикновен хляб.	Plain bread.
момиче	girl	Момичето пее.	The girl sings.
Обичайната	usual	Обичайното време.	The usual time.
млад	young	Младият мъж работи.	The young man works.
готова	ready	Готов ли си?	Are you ready?
горе	above	Над облаците.	Above the clouds.
някога	ever	Бил ли си някога в Париж?	Have you ever been to Paris?
червено	red	Червена роза.	A red rose.
списък	list	Направи списък за пазаруване.	Make a shopping list.
макар	though	Макар и да е трудно.	Though it's difficult.
почувствате	feel	Чувствам се добре.	I feel good.
приказки	talk	Говорим за времето.	We talk about the weather.
птица	bird	Птицата лети.	The bird flies.
скоро	soon	Скоро ще дойда.	I'll come soon.
тяло	body	Спортът е добър за тялото.	Sports are good for the body.
куче	dog	Кучето лае.	The dog barks.
семейство	family	Семейството е важно.	Family is important.
директен	direct	Директен полет.	A direct flight.
представляват	pose	Позирай за снимката.	Pose for the picture.
напусне	leave	Тръгвам в 5 часа.	I leave at 5 o'clock.
песен	song	Песента е красива.	The song is beautiful.
измерва	measure	Измери дължината.	Measure the length.
врата	door	Затвори вратата.	Close the door.
продукт	product	Новият продукт е добър.	The new product is good.
черен	black	Черната котка спи.	The black cat sleeps.
кратко	short	Краткото разстояние.	The short distance.
цифра	numeral	Напиши числото.	Write the numeral.
клас	class	Класът започва в 9 часа.	Class starts at 9 o'clock.
вятър	wind	Вятърът духа силно.	The wind blows hard.
въпрос	question	Имам въпрос.	I have a question.
се случи	happen	Какво се случи?	What happened?
пълен	complete	Завърши задачата.	Complete the task.
кораб	ship	Корабът пътува.	The ship travels.
област	area	Тази област е красива.	This area is beautiful.
половината	half	Половината от торта.	Half of the cake.
рок	rock	Рок музика.	Rock music.
За	order	Поръчай храна.	Order food.
пожар	fire	Огънят гори.	The fire burns.
на юг	south	На юг от града.	South of the city.
проблем	problem	Има проблем.	There's a problem.
парче	piece	Парче торта.	A piece of cake.
каза	told	Казах му истината.	I told him the truth.
Знаех	knew	Знаех отговора.	I knew the answer.
мине	pass	Минах покрай къщата.	I passed by the house.
тъй като	since	Тъй като е дъждовно.	Since it's rainy.
отгоре	top	На върха на планината.	At the top of the mountain.
Цялата	whole	Цялата история.	The whole story.
цар	king	Царят управлява.	The king rules.
улица	street	Живея на тази улица.	I live on this street.
инч	inch	Един инч дължина.	One inch long.
размножават	multiply	Умножи числата.	Multiply the numbers.
нищо	nothing	Нищо не се случи.	Nothing happened.
курс	course	Курс по английски.	An English course.
престой	stay	Остани тук.	Stay here.
колело	wheel	Колелото се върти.	The wheel turns.
пълен	full	Пълна чаша вода.	A full glass of water.
сила	force	Използвай силата.	Use the force.
син	blue	Синьото небе.	The blue sky.
обект	object	Странен обект.	A strange object.
реши	decide	Реши бързо.	Decide quickly.
повърхност	surface	Гладката повърхност.	The smooth surface.
дълбоко	deep	Дълбокото езеро.	The deep lake.
луна	moon	Луната свети.	The moon shines.
остров	island	Малкият остров.	The small island.
крак	foot	Боли ме кракът.	My foot hurts.
система	system	Компютърната система.	The computer system.
зает	busy	Зает съм с работа.	I'm busy with work.
тест	test	Теста е утре.	The test is tomorrow.
рекорд	record	Записах песента.	I recorded the song.
лодка	boat	Лодката плава.	The boat sails.
обща	common	Обща практика.	Common practice.
злато	gold	Златният пръстен.	The gold ring.
възможно	possible	Възможно ли е?	Is it possible?
самолет	plane	Самолетът излетя.	The plane took off.
вместо	stead	Вместо мен.	Instead of me.
сухо	dry	Сухото време.	The dry weather.
Чудя	wonder	Чудя се какво прави.	I wonder what he's doing.
смях	laugh	Смея се на шегата.	I laugh at the joke.
хиляди	thousand	Хиляди хора.	Thousands of people.
преди	ago	Преди година.	A year ago.
завтече	ran	Тичах бързо.	I ran fast.
проверите	check	Провери отговора.	Check the answer.
игра	game	Играем футбол.	We play a game.
форма	shape	Формата на кръга.	The shape of the circle.
приравняват	equate	Приравни числата.	Equate the numbers.
горещ	hot	Горещата супа.	The hot soup.
Мис	miss	Липсваш ми.	I miss you.
предявен	brought	Донесох подарък.	I brought a gift.
топлина	heat	Топлината на слънцето.	The heat of the sun.
сняг	snow	Снегът пада.	The snow falls.
гума	tire	Гумата на колата.	The tire of the car.
донесе	bring	Донеси ми вода.	Bring me water.
Да	yes	Да, съгласен съм.	Yes, I agree.
далечен	distant	Далечната планета.	The distant planet.
попълнете	fill	Попълни формуляра.	Fill out the form.
изток	east	На изток от града.	East of the city.
боя	paint	Боядисай стената.	Paint the wall.
език	language	Уча нов език.	I'm learning a new language.
сред	among	Сред приятелите.	Among friends.
единица	unit	Единица за измерване.	A unit of measurement.
мощност	power	Електрическата мощност.	The electric power.
град	town	Малкият град.	The small town.
глоба	fine	Платих глоба.	I paid a fine.
определен	certain	Определен човек.	A certain person.
лети	fly	Птицата лети.	The bird flies.
падне	fall	Листата падат.	The leaves fall.
доведе	lead	Води пътя.	Lead the way.
вик	cry	Детето плаче.	The child cries.
тъмно	dark	Тъмната нощ.	The dark night.
машина	machine	Машината работи.	The machine works.
бележка	note	Остави бележка.	Leave a note.
изчакайте	wait	Чакай тук.	Wait here.
план	plan	Направи план.	Make a plan.
фигура	figure	Геометрична фигура.	A geometric figure.
звезда	star	Звездата свети.	The star shines.
кутия	box	Кутията е празна.	The box is empty.
съществително	noun	Това е съществително име.	This is a noun.
поле	field	Полето е зелено.	The field is green.
почивка	rest	Почивам след работа.	I rest after work.
правилно	correct	Правилният отговор.	The correct answer.
състояние	able	Способен съм да помогна.	I'm able to help.
лира	pound	Фунт стерлинги.	Pound sterling.
Готово	done	Готово с работата.	Done with work.
красота	beauty	Красотата на природата.	The beauty of nature.
диск	drive	Кара колата.	Drive the car.
стоеше	stood	Стоях на опашка.	I stood in line.
съдържа	contain	Кутията съдържа книги.	The box contains books.
пред	front	Пред къщата.	In front of the house.
преподават	teach	Преподавам английски.	I teach English.
седмица	week	Тази седмица работя.	I work this week.
окончателния	final	Финалният резултат.	The final result.
даде	gave	Дадох му подарък.	I gave him a gift.
зелено	green	Зеленото дърво.	The green tree.
о	oh	О, забравих!	Oh, I forgot!
бърз	quick	Бърза разходка.	A quick walk.
разработят	develop	Развивам нови идеи.	I develop new ideas.
океана	ocean	Океанът е дълбок.	The ocean is deep.
топло	warm	Топлото време.	The warm weather.
безплатно	free	Безплатен достъп.	Free access.
минути	minute	Една минута, моля.	One minute, please.
силен	strong	Силният мъж.	The strong man.
специален	special	Специален ден.	A special day.
ума	mind	Променя мнението си.	Change your mind.
зад	behind	Зад къщата.	Behind the house.
ясно	clear	Ясното небе.	The clear sky.
опашка	tail	Опашката на кучето.	The dog's tail.
производство	produce	Произвеждам храна.	I produce food.
Всъщност	fact	Всъщност е вярно.	It's actually a fact.
пространство	space	Космическото пространство.	Outer space.
Чух	heard	Чух новината.	I heard the news.
Най-добрият	best	Най-добрата песен.	The best song.
часа	hour	Един час работа.	One hour of work.
по-добре	better	По-добре от вчера.	Better than yesterday.
вярно	true	Истинската история.	The true story.
по време на	during	По време на урока.	During the lesson.
сто	hundred	Сто души.	One hundred people.
пет	five	Пет ябълки.	Five apples.
Спомням си	remember	Спомням си това.	I remember that.
стъпка	step	Направи стъпка напред.	Take a step forward.
началото	early	В ранните часове.	In the early hours.
държа	hold	Държи моята ръка.	Hold my hand.
west	west	На запад от града.	West of the city.
земята	ground	На земята има листа.	There are leaves on the ground.
интерес	interest	Интересът ми е музика.	My interest is music.
достигне	reach	Достигни до върха.	Reach the top.
бързо	fast	Карай бързо.	Drive fast.
глагол	verb	Това е глагол.	This is a verb.
пея	sing	Пея песен.	I sing a song.
слушате	listen	Слушай музиката.	Listen to the music.
шест	six	Шест котки.	Six cats.
маса	table	Масата е дървена.	The table is wooden.
пътуване	travel	Пътувам в чужбина.	I travel abroad.
по-малко	less	По-малко работа.	Less work.
сутрин	morning	Добро утро!	Good morning!
десет	ten	Десет пръста.	Ten fingers.
прост	simple	Проста задача.	A simple task.
няколко	several	Няколко дни.	Several days.
гласна	vowel	Гласна буква.	A vowel letter.
към	toward	Към центъра.	Toward the center.
война	war	Войната завърши.	The war ended.
лежеше	lay	Лежах на леглото.	I lay on the bed.
срещу	against	Срещу правилата.	Against the rules.
модел	pattern	Модел на дрехи.	A clothing pattern.
бавен	slow	Бавна музика.	Slow music.
център	center	В центъра на града.	In the center of the city.
обичам	love	Обичам те.	I love you.
човек	person	Добър човек.	A good person.
пари	money	Спестявам пари.	I save money.
послужи	serve	Сервирай храната.	Serve the food.
се появи	appear	Появи се внезапно.	He appeared suddenly.
път	road	Дългият път.	The long road.
Карта	map	Картата показва пътя.	The map shows the way.
дъжд	rain	Дъждът спря.	The rain stopped.
правило	rule	Следвай правилата.	Follow the rules.
управлява	govern	Управлява страната.	He governs the country.
дръпнете	pull	Дръпни вратата.	Pull the door.
студено	cold	Студеното време.	The cold weather.
предизвестие	notice	Забелязах промяната.	I noticed the change.
глас	voice	Красивият глас.	The beautiful voice.
енергия	energy	Енергията на младостта.	The energy of youth.
лов	hunt	Ловува в гората.	He hunts in the forest.
вероятен	probable	Вероятно ще дойде.	He'll probably come.
легло	bed	Леглото е удобно.	The bed is comfortable.
брат	brother	Моят брат работи.	My brother works.
яйце	egg	Варено яйце.	A boiled egg.
езда	ride	Яздя кон.	I ride a horse.
клетка	cell	Клетката се дели.	The cell divides.
Вярвам	believe	Вярвам в теб.	I believe in you.
може би	perhaps	Може би утре.	Perhaps tomorrow.
вземете	pick	Избери ябълка.	Pick an apple.
внезапна	sudden	Внезапна промяна.	A sudden change.
брои	count	Брой до десет.	Count to ten.
квадрат	square	Квадратна форма.	A square shape.
причина	reason	Каква е причината?	What's the reason?
дължина	length	Дължината на реката.	The length of the river.
представляват	represent	Представлявам компанията.	I represent the company.
изкуство	art	Изкуството е красиво.	Art is beautiful.
Заглавие	subject	Предметът в училище.	The subject in school.
област	region	Планинската област.	The mountain region.
размер	size	Размерът на обувката.	The size of the shoe.
варира	vary	Цените варират.	Prices vary.
уредят	settle	Уреди проблема.	Settle the problem.
говори	speak	Говоря български.	I speak Bulgarian.
тегло	weight	Теглото на багажа.	The weight of the luggage.
общо	general	Общо мнение.	General opinion.
лед	ice	Ледът се топи.	The ice melts.
материя	matter	Това не е важно.	This doesn't matter.
кръг	circle	Нарисувай кръг.	Draw a circle.
двойка	pair	Двойка обувки.	A pair of shoes.
включва	include	Включва всичко.	It includes everything.
разделяй	divide	Раздели торта на части.	Divide the cake into pieces.
сричка	syllable	Думата има три срички.	The word has three syllables.
чувствах	felt	Чувствах се добре.	I felt good.
бона	grand	Голяма сума пари.	A grand sum of money.
топка	ball	Топката е кръгла.	The ball is round.
още	yet	Още не съм готов.	I'm not ready yet.
вълна	wave	Вълните на морето.	The waves of the sea.
пуснете	drop	Пусни топката.	Drop the ball.
сърце	heart	Сърцето ми бие.	My heart beats.
съм	am	Аз съм учител.	I am a teacher.
настоящето	present	Настоящият момент.	The present moment.
тежък	heavy	Тежката кутия.	The heavy box.
танц	dance	Танцуваме на парти.	We dance at the party.
двигател	engine	Двигателят работи.	The engine works.
позиция	position	Позицията на играча.	The player's position.
ръка	arm	Ръката ме боли.	My arm hurts.
широк	wide	Широката река.	The wide river.
платно	sail	Платната на кораба.	The ship's sail.
материали	material	Строителни материали.	Building materials.
фракция	fraction	Една втора част.	One half fraction.
гора	forest	Гората е гъста.	The forest is dense.
седя	sit	Седя на стола.	I sit on the chair.
раса	race	Надпреварата започна.	The race began.
прозорец	window	Отвори прозореца.	Open the window.
магазин	store	Магазинът е затворен.	The store is closed.
лято	summer	Лятото е горещо.	Summer is hot.
влак	train	Влакът пристигна.	The train arrived.
сън	sleep	Спя осем часа.	I sleep eight hours.
докаже	prove	Докажи истината.	Prove the truth.
самотен	lone	Самотна звезда.	A lone star.
крак	leg	Кракът ме боли.	My leg hurts.
упражнение	exercise	Правя упражнения.	I do exercises.
стена	wall	Стената е висока.	The wall is high.
улова	catch	Хвани топката.	Catch the ball.
монтиране	mount	Качи се на планината.	Mount the mountain.
Иска	wish	Пожелавам си късмет.	I wish for luck.
небе	sky	Небето е синьо.	The sky is blue.
борда	board	Дъската за писане.	The writing board.
радост	joy	Радостта от успеха.	The joy of success.
зимата	winter	Зимата е студена.	Winter is cold.
сб	sat	Седях на пейката.	I sat on the bench.
писмен	written	Писмено съобщение.	A written message.
див	wild	Дивото животно.	The wild animal.
инструмент	instrument	Музикален инструмент.	A musical instrument.
съхраняват	kept	Пазя спомените.	I kept the memories.
стъкло	glass	Чашата от стъкло.	The glass cup.
трева	grass	Тревата е зелена.	The grass is green.
крава	cow	Кравата дава мляко.	The cow gives milk.
работа	job	Работата ми е интересна.	My job is interesting.
ръб	edge	Ръбът на масата.	The edge of the table.
знак	sign	Пътният знак.	The road sign.
посещение	visit	Посетих приятел.	I visited a friend.
минало	past	В миналото.	In the past.
мека	soft	Мека възглавница.	A soft pillow.
забавно	fun	Забавна игра.	A fun game.
ярък	bright	Ярката светлина.	The bright light.
газ	gas	Природният газ.	Natural gas.
Прогноза за времето	weather	Времето е хубаво.	The weather is nice.
месеца	month	Този месец работя много.	I work a lot this month.
милиона	million	Един милион души.	One million people.
понесе	bear	Мечката спи.	The bear sleeps.
завършеност	finish	Завърши проекта.	Finish the project.
щастлив	happy	Щастлив рожден ден!	Happy birthday!
Надявам се,	hope	Надявам се да успея.	I hope to succeed.
цвете	flower	Цветето мирише хубаво.	The flower smells nice.
облече	clothe	Облечи се топло.	Dress warmly.
странен	strange	Странна история.	A strange story.
изчезнал	gone	Той си е отишъл.	He is gone.
търговия	trade	Търговията процъфтява.	Trade flourishes.
мелодия	melody	Красива мелодия.	A beautiful melody.
пътуване	trip	Пътуването беше хубаво.	The trip was nice.
офис	office	Офисът е на третия етаж.	The office is on the third floor.
получавате	receive	Получих твоето писмо.	I received your letter.
ред	row	Седя на първия ред.	I sit in the first row.
устата	mouth	Отвори устата си.	Open your mouth.
Точната	exact	Точното време.	The exact time.
символ	symbol	Символът на мира.	The symbol of peace.
умре	die	Растението умря.	The plant died.
-малко	least	Най-малко десет души.	At least ten people.
беда	trouble	Имам проблем.	I have trouble.
вик	shout	Викай силно.	Shout loudly.
с изключение на	except	Всички освен мен.	Everyone except me.
пише	wrote	Написах писмо.	I wrote a letter.
семена	seed	Засея семена.	I planted seeds.
тон	tone	Тонът на гласа.	The tone of voice.
присъединят	join	Присъедини се към нас.	Join us.
Предлагам	suggest	Предлагам решение.	I suggest a solution.
чиста	clean	Почисти стаята.	Clean the room.
почивка	break	Направи почивка.	Take a break.
дама	lady	Елегантна дама.	An elegant lady.
двор	yard	Дворът е голям.	The yard is big.
покачва	rise	Слънцето изгрява.	The sun rises.
лошо	bad	Лошо време.	Bad weather.
удар	blow	Силен удар.	A strong blow.
масло	oil	Зехтинено масло.	Olive oil.
кръв	blood	Кръвта е червена.	Blood is red.
докосвайте	touch	Докосни повърхността.	Touch the surface.
израснал	grew	Порасна много.	He grew a lot.
сто	cent	Сто цента.	One hundred cents.
смесвам	mix	Смеси съставките.	Mix the ingredients.
екип	team	Нашият екип печели.	Our team wins.
тел	wire	Електрическата жица.	The electric wire.
цена	cost	Цената е висока.	The cost is high.
загубени	lost	Загубих ключа.	I lost the key.
кафяв	brown	Кафявото куче.	The brown dog.
износване	wear	Нося нови дрехи.	I wear new clothes.
градина	garden	Градината е красива.	The garden is beautiful.
равен	equal	Равни възможности.	Equal opportunities.
изпрати	sent	Изпратих съобщение.	I sent a message.
избирам	choose	Избирам ябълка.	I choose an apple.
падна	fell	Листото падна.	The leaf fell.
поберат	fit	Пасва ми перфектно.	It fits me perfectly.
дебит	flow	Водата тече.	The water flows.
справедлив	fair	Справедливо решение.	A fair decision.
банка	bank	Банката е затворена.	The bank is closed.
събира	collect	Събирам марки.	I collect stamps.
запишете	save	Спаси документа.	Save the document.
контрол	control	Контролирай скоростта.	Control the speed.
десетични	decimal	Десетична дроб.	A decimal fraction.
ухото	ear	Ухото ме боли.	My ear hurts.
другаде	else	Някъде другаде.	Somewhere else.
съвсем	quite	Съвсем доволен.	Quite satisfied.
проби	broke	Счупих чашата.	I broke the glass.
случай	case	В този случай.	In this case.
средна	middle	Средната стойност.	The middle value.
убие	kill	Времето убива.	Time kills.
син	son	Синът ми учи.	My son studies.
езеро	lake	Езерото е дълбоко.	The lake is deep.
момент	moment	В този момент.	At this moment.
мащаб	scale	Мащабът на картата.	The scale of the map.
силен	loud	Силен звук.	A loud sound.
пролетта	spring	Пролетта идва.	Spring comes.
спазвайте	observe	Наблюдавай звездите.	Observe the stars.
дете	child	Детето играе.	The child plays.
направо	straight	Върви право.	Go straight.
съгласна	consonant	Съгласна буква.	A consonant letter.
нация	nation	Голяма нация.	A great nation.
речник	dictionary	Използвай речника.	Use the dictionary.
мляко	milk	Пия мляко сутрин.	I drink milk in the morning.
скорост	speed	Скоростта е голяма.	The speed is high.
метод	method	Новият метод работи.	The new method works.
органна	organ	Органната музика.	Organ music.
заплати	pay	Плати сметката.	Pay the bill.
възраст	age	На каква възраст си?	What age are you?
раздел	section	Този раздел е важен.	This section is important.
рокля	dress	Красивата рокля.	The beautiful dress.
облак	cloud	Облакът е бял.	The cloud is white.
изненада	surprise	Приятна изненада.	A pleasant surprise.
тих	quiet	Тихо място.	A quiet place.
камък	stone	Камъкът е твърд.	The stone is hard.
мъничък	tiny	Мъничко котенце.	A tiny kitten.
изкачване	climb	Катери се на дървото.	Climb the tree.
готино	cool	Готинско място.	A cool place.
дизайн	design	Дизайнът е модерен.	The design is modern.
лошо	poor	Беден човек.	A poor person.
много	lot	Много работа.	A lot of work.
експеримент	experiment	Научният експеримент.	The scientific experiment.
дъно	bottom	На дъното на морето.	At the bottom of the sea.
ключ	key	Ключът от къщата.	The key to the house.
желязо	iron	Желязната ограда.	The iron fence.
единичен	single	Единствен шанс.	A single chance.
стик	stick	Дървената пръчка.	The wooden stick.
плосък	flat	Плоската повърхност.	The flat surface.
двадесет	twenty	Двадесет години.	Twenty years.
кожата	skin	Кожата е мека.	The skin is soft.
усмивка	smile	Красива усмивка.	A beautiful smile.
гънки	crease	Гънка на дрехата.	A crease in the clothing.
дупка	hole	Дупка в стената.	A hole in the wall.
скочи	jump	Скочи високо.	Jump high.
бебе	baby	Бебето спи.	The baby sleeps.
осем	eight	Осем часа работа.	Eight hours of work.
село	village	Малкото село.	The small village.
Запознайте	meet	Запознай се с приятели.	Meet friends.
корен	root	Корена на дървото.	The root of the tree.
Купува	buy	Купувам хляб.	I buy bread.
повишаване на	raise	Повиши ръката си.	Raise your hand.
решаване	solve	Реши проблема.	Solve the problem.
метал	metal	Металната кутия.	The metal box.
дали	whether	Дали ще дойдеш?	Whether you'll come?
тласък	push	Бутни вратата.	Push the door.
седем	seven	Седем дни.	Seven days.
параграф	paragraph	Прочети параграфа.	Read the paragraph.
трети	third	Третия етаж.	The third floor.
трябва	shall	Ще направя това.	I shall do this.
задържано	held	Държах книгата.	I held the book.
коса	hair	Косата е дълга.	The hair is long.
опише	describe	Опиши картината.	Describe the picture.
готвач	cook	Готвача прави вечеря.	The cook makes dinner.
етаж	floor	Вторият етаж.	The second floor.
или	either	Или това, или онова.	Either this or that.
резултат	result	Резултатът е добър.	The result is good.
горят	burn	Дървата горят.	The wood burns.
хълм	hill	Върху хълма.	On the hill.
безопасно	safe	Безопасно място.	A safe place.
котка	cat	Котката мяука.	The cat meows.
век	century	Двадесет и първия век.	The twenty-first century.
помисли	consider	Помисли за предложението.	Consider the proposal.
тип	type	Какъв тип музика?	What type of music?
закон	law	Законът е строг.	The law is strict.
малко	bit	Малко захар.	A bit of sugar.
крайбрежие	coast	Крайбрежието е красиво.	The coast is beautiful.
копие	copy	Направи копие.	Make a copy.
фрази	phrase	Популярна фраза.	A popular phrase.
мълчалив	silent	Мълчалива нощ.	A silent night.
висок	tall	Високо дърво.	A tall tree.
пясък	sand	Пясъкът е топъл.	The sand is warm.
почвата	soil	Плодородната почва.	The fertile soil.
ролка	roll	Ролка тоалетна хартия.	A roll of toilet paper.
температура	temperature	Високата температура.	The high temperature.
пръста	finger	Пръстът ме боли.	My finger hurts.
промишленост	industry	Автомобилната промишленост.	The automotive industry.
стойност	value	Стойността на къщата.	The value of the house.
борба	fight	Борбата продължава.	The fight continues.
лъжа	lie	Не казвай лъжи.	Don't tell lies.
победи	beat	Победи противника.	Beat the opponent.
възбуди	excite	Възбудих се от новината.	I got excited by the news.
естествено	natural	Естествената красота.	Natural beauty.
Предвид	view	Гледката е прекрасна.	The view is wonderful.
смисъл	sense	Смисълът на живота.	The sense of life.
капитал	capital	Столицата на България.	The capital of Bulgaria.
не ще	won't	Няма да дойда.	I won't come.
стол	chair	Седя на стола.	I sit on the chair.
опасност	danger	Опасност от пожар.	Danger of fire.
плодове	fruit	Прясна плодове.	Fresh fruit.
богат	rich	Богат човек.	A rich person.
дебела	thick	Дебела книга.	A thick book.
войник	soldier	Войникът маршира.	The soldier marches.
процес	process	Процесът е сложен.	The process is complex.
работи	operate	Машината работи добре.	The machine operates well.
практика	practice	Практиката прави съвършенство.	Practice makes perfect.
отделно	separate	Отделни стаи.	Separate rooms.
трудно	difficult	Трудна задача.	A difficult task.
лекар	doctor	Лекарят прегледа пациента.	The doctor examines the patient.
моля	please	Моля, помогни ми.	Please, help me.
защитавам	protect	Защитавам семейството си.	I protect my family.
обяд	noon	На обяд ядем.	We eat at noon.
култура	crop	Земеделската култура.	The agricultural crop.
модерна	modern	Модерна технология.	Modern technology.
елемент	element	Химичен елемент.	A chemical element.
хит	hit	Удари топката.	Hit the ball.
студент	student	Студентът учи.	The student studies.
ъгъл	corner	В ъгъла на стаята.	In the corner of the room.
парти	party	Парти за рожден ден.	A birthday party.
доставка	supply	Доставката пристигна.	The supply arrived.
чиято	whose	Чиято книга е това?	Whose book is this?
намерете	locate	Намери адреса.	Locate the address.
пръстен	ring	Златен пръстен.	A gold ring.
характер	character	Добър характер.	Good character.
насекоми	insect	Насекомото лети.	The insect flies.
уловени	caught	Хванах риба.	I caught a fish.
период	period	Период на растеж.	A period of growth.
посочете	indicate	Посочи посоката.	Indicate the direction.
радио	radio	Слушам радио.	I listen to the radio.
Говорих	spoke	Говорих с него вчера.	I spoke with him yesterday.
атом	atom	Атомът е малък.	The atom is small.
човешкото	human	Човешкото тяло.	The human body.
история	history	Историята е интересна.	History is interesting.
ефект	effect	Ефектът е силен.	The effect is strong.
електрически	electric	Електрическа лампа.	An electric lamp.
очаквайте	expect	Очаквам гости.	I expect guests.
костна	bone	Костта е счупена.	The bone is broken.
железопътния	rail	Железопътната линия.	The railway line.
представете си	imagine	Представи си това.	Imagine this.
предоставят	provide	Предоставям услуги.	I provide services.
Съгласен	agree	Съгласен съм с теб.	I agree with you.
по този начин	thus	По този начин работи.	Thus it works.
нежен	gentle	Нежно докосване.	A gentle touch.
жена	woman	Жената работи.	The woman works.
капитан	captain	Капитанът командва.	The captain commands.
Предполагам, че	guess	Предполагам, че ще дойде.	I guess he will come.
необходимо	necessary	Необходимо е да работиш.	It's necessary to work.
рязък	sharp	Острия нож.	The sharp knife.
крило	wing	Крилото на птицата.	The bird's wing.
създадете	create	Създай нещо ново.	Create something new.
съсед	neighbor	Съседът е мил.	The neighbor is kind.
измиване	wash	Измий ръцете си.	Wash your hands.
прилеп	bat	Прилепът лети нощем.	The bat flies at night.
по-скоро	rather	По-скоро бих останал.	I'd rather stay.
тълпа	crowd	Голяма тълпа хора.	A big crowd of people.
царевица	corn	Царевицата расте.	The corn grows.
сравни	compare	Сравни цените.	Compare the prices.
стихотворение	poem	Красива поема.	A beautiful poem.
низ	string	Низ от перли.	A string of pearls.
звънец	bell	Звънецът звъни.	The bell rings.
зависи	depend	Зависи от времето.	It depends on the weather.
месо	meat	Месото е вкусно.	The meat is delicious.
RUB	rub	Натри с крем.	Rub with cream.
тръба	tube	Тръбата е дълга.	The tube is long.
Известният	famous	Известният актьор.	The famous actor.
долар	dollar	Един долар струва много.	One dollar costs a lot.
поток	stream	Потокът тече бързо.	The stream flows fast.
страх	fear	Страх от височини.	Fear of heights.
зрението	sight	Зрението ми е добро.	My sight is good.
тънък	thin	Тънка хартия.	Thin paper.
триъгълник	triangle	Геометричен триъгълник.	A geometric triangle.
планета	planet	Планетата Земя.	Planet Earth.
побързайте	hurry	Бързай, закъсняваме!	Hurry, we're late!
главен	chief	Главният инженер.	The chief engineer.
колония	colony	Колонията от мравки.	The colony of ants.
часовник	clock	Часовникът показва време.	The clock shows time.
мина	mine	Въглищната мина.	The coal mine.
вратовръзка	tie	Завържи вратовръзката.	Tie the necktie.
въведете	enter	Влез в стаята.	Enter the room.
основен	major	Основен проблем.	A major problem.
пресен	fresh	Пресен въздух.	Fresh air.
търсене	search	Търся новата си книга.	I search for my new book.
изпрати	send	Изпрати писмо.	Send a letter.
жълт	yellow	Жълтото цвете.	The yellow flower.
пистолет	gun	Пистолетът е опасен.	The gun is dangerous.
позволи	allow	Позволи ми да помогна.	Allow me to help.
печат	print	Отпечатай документа.	Print the document.
мъртъв	dead	Мъртвото растение.	The dead plant.
място	spot	Това е хубаво място.	This is a nice spot.
пустиня	desert	Пустинята е суха.	The desert is dry.
костюм	suit	Елегантен костюм.	An elegant suit.
ток	current	Електрическият ток.	The electric current.
повдигане	lift	Вдигни тежестта.	Lift the weight.
роза	rose	Червената роза.	The red rose.
пристигнете	arrive	Пристигнах навреме.	I arrived on time.
майстор	master	Майсторът работи добре.	The master works well.
песен	track	Музикална песен.	A music track.
родител	parent	Родителят обича детето.	The parent loves the child.
брега	shore	Брегът на морето.	The shore of the sea.
разделение	division	Разделение на труда.	Division of labor.
лист	sheet	Лист хартия.	A sheet of paper.
вещество	substance	Химично вещество.	A chemical substance.
благоприятства	favor	В полза на всички.	In favor of everyone.
свържете	connect	Свържи кабелите.	Connect the cables.
Мнение	post	Публикувай мнението си.	Post your opinion.
прекарат	spend	Прекарвам време с приятели.	I spend time with friends.
акорд	chord	Музикален акорд.	A musical chord.
мазнини	fat	Мазнините са вредни.	Fats are harmful.
Радвам	glad	Радвам се да те видя.	I'm glad to see you.
първоначалното	original	Оригиналната идея.	The original idea.
акции	share	Споделям храната.	I share the food.
станция	station	Железопътната станция.	The railway station.
Баща	dad	Татко работи.	Dad works.
хляб	bread	Прясно изпечен хляб.	Freshly baked bread.
зареждане	charge	Зареди телефона.	Charge the phone.
правилното	proper	Правилното поведение.	Proper behavior.
бар	bar	Бар за напитки.	A drinks bar.
оферта	offer	Предлагам помощ.	I offer help.
сегмент	segment	Сегмент от програмата.	A segment of the program.
роб	slave	Робът работи тежко.	The slave works hard.
патица	duck	Патицата плува.	The duck swims.
миг	instant	В един миг.	In an instant.
пазар	market	Пазарът е оживен.	The market is busy.
степен	degree	Степен от университета.	A degree from university.
пренесат	populate	Населяват града.	They populate the city.
мацка	chick	Малкото пиле.	The little chick.
Уважаеми	dear	Скъпи приятелю.	Dear friend.
враг	enemy	Врагът е близо.	The enemy is near.
отговаряте	reply	Отговори на въпроса.	Reply to the question.
питие	drink	Питие за жажда.	A drink for thirst.
възникне	occur	Възниква проблем.	A problem occurs.
подкрепа	support	Подкрепям предложението.	I support the proposal.
реч	speech	Речта беше дълга.	The speech was long.
природата	nature	Природата е красива.	Nature is beautiful.
диапазон	range	Диапазон от възможности.	A range of possibilities.
пара	steam	Парата се издига.	The steam rises.
Предложение	motion	Предложение за промяна.	A motion for change.
път	path	Пътеката през гората.	The path through the forest.
течност	liquid	Течността тече.	The liquid flows.
влезете	log	Влез в системата.	Log into the system.
означаваше	meant	Имаше предвид това.	He meant this.
коефициент	quotient	Математически коефициент.	A mathematical quotient.
зъби	teeth	Зъбите са бели.	The teeth are white.
черупка	shell	Черупката на яйцето.	The shell of the egg.
шията	neck	Шията ме боли.	My neck hurts.
кислород	oxygen	Кислородът е важен.	Oxygen is important.
захар	sugar	Захарта е сладка.	Sugar is sweet.
смърт	death	Смъртта е част от живота.	Death is part of life.
доста	pretty	Доста красива.	Pretty beautiful.
умения	skill	Уменията са важни.	Skills are important.
жените	women	Жените работят.	Women work.
сезон	season	Пролетният сезон.	The spring season.
разтвор	solution	Решение на проблема.	A solution to the problem.
магнит	magnet	Магнитът привлича.	The magnet attracts.
сребро	silver	Сребърната огърлица.	The silver necklace.
благодаря	thank	Благодаря за помощта.	Thank you for the help.
клон	branch	Клонът на дървото.	The branch of the tree.
мач	match	Футболният мач.	The football match.
наставка	suffix	Граматическа наставка.	A grammatical suffix.
особено	especially	Особено важно.	Especially important.
фиг	fig	Смокинята е сладка.	The fig is sweet.
Страхувам се	afraid	Боя се от тъмното.	I'm afraid of the dark.
огромен	huge	Огромна къща.	A huge house.
сестра	sister	Сестра ми пее.	My sister sings.
стомана	steel	Стоманената конструкция.	The steel construction.
обсъдят	discuss	Обсъждаме плановете.	We discuss the plans.
напред	forward	Върви напред.	Go forward.
Подобна	similar	Подобна ситуация.	A similar situation.
ръководят	guide	Ръководи групата.	Guide the group.
опит	experience	Опитът учи.	Experience teaches.
резултат	score	Резултатът от играта.	The score of the game.
ябълка	apple	Червената ябълка.	The red apple.
Купих	bought	Купих нова кола.	I bought a new car.
водена	led	Водих групата.	I led the group.
Стъпка	pitch	Стъпката на звука.	The pitch of sound.
палто	coat	Зимното палто.	The winter coat.
маса	mass	Голяма маса хора.	A large mass of people.
карта	card	Игрална карта.	A playing card.
лента	band	Музикална група.	A music band.
въже	rope	Дебелото въже.	The thick rope.
приплъзване	slip	Подхлъзнах се на леда.	I slipped on the ice.
победа	win	Победата е наша.	The victory is ours.
мечтая	dream	Мечтая за бъдещето.	I dream of the future.
вечер	evening	Добра вечер!	Good evening!
състояние	condition	В добро състояние.	In good condition.
фуражи	feed	Храни животните.	Feed the animals.
инструмент	tool	Работният инструмент.	The work tool.
Общият брой на	total	Общата сума.	The total amount.
основен	basic	Основни знания.	Basic knowledge.
миризма	smell	Приятна миризма.	A pleasant smell.
долина	valley	Зелената долина.	The green valley.
нито	nor	Нито това, нито онова.	Neither this nor that.
двойно	double	Двойна порция.	A double portion.
седалка	seat	Удобната седалка.	The comfortable seat.
продължи	continue	Продължи работата.	Continue the work.
блок	block	Жилищен блок.	A residential block.
диаграма	chart	Диаграмата показва данни.	The chart shows data.
шапка	hat	Зимната шапка.	The winter hat.
продават	sell	Продавам книги.	I sell books.
успех	success	Успехът изисква работа.	Success requires work.
компанията	company	Компанията расте.	The company grows.
изважда	subtract	Извади числото.	Subtract the number.
събитие	event	Важно събитие.	An important event.
специално	particular	Специален случай.	A particular case.
сделка	deal	Добра сделка.	A good deal.
плуване	swim	Плувам в басейна.	I swim in the pool.
Терминът	term	Терминът завършва.	The term ends.
противоположна	opposite	Противоположната посока.	The opposite direction.
жена	wife	Жената ми готви.	My wife cooks.
обувки	shoe	Новите обувки.	The new shoes.
рамото	shoulder	Рамото ме боли.	My shoulder hurts.
разпространение	spread	Разпространи новината.	Spread the news.
организира	arrange	Организирай срещата.	Arrange the meeting.
лагер	camp	Летният лагер.	The summer camp.
измислят	invent	Измисли ново решение.	Invent a new solution.
памук	cotton	Памучната тениска.	The cotton t-shirt.
Роден	born	Роден съм в София.	I was born in Sofia.
определи	determine	Определи причината.	Determine the cause.
кварта	quart	Един кварта мляко.	One quart of milk.
девет	nine	Девет котки.	Nine cats.
камион	truck	Големият камион.	The big truck.
шум	noise	Силният шум.	The loud noise.
ниво	level	Високо ниво.	High level.
шанс	chance	Добър шанс за успех.	A good chance for success.
събират	gather	Събираме се в парка.	We gather in the park.
магазин	shop	Магазинът за дрехи.	The clothing shop.
участък	stretch	Участък от пътя.	A stretch of road.
хвърлят	throw	Хвърли топката.	Throw the ball.
блясък	shine	Блясъкът на слънцето.	The shine of the sun.
имот	property	Частната собственост.	Private property.
колона	column	Колоната от числа.	The column of numbers.
молекула	molecule	Молекулата е малка.	The molecule is small.
изберете	select	Избери най-доброто.	Select the best.
Грешна	wrong	Грешният отговор.	The wrong answer.
сив	gray	Сивото небе.	The gray sky.
повторете	repeat	Повтори урока.	Repeat the lesson.
изисква	require	Изисква внимание.	It requires attention.
широк	broad	Широката алея.	The broad avenue.
подготви	prepare	Подготви се за изпита.	Prepare for the exam.
сол	salt	Морската сол.	Sea salt.
носа	nose	Носът ми тече.	My nose is running.
множествено число	plural	Множественото число.	The plural form.
гнева	anger	Гневът е вреден.	Anger is harmful.
твърдение	claim	Твърдението е вярно.	The claim is true.
континент	continent	Европейският континент.	The European continent.